rt	OOV	art
@teddyferrari1	NO	@teddyferrari1
ah	IV	ah
@datzmenoni	NO	@datzmenoni
why	IV	why
sub	IV	sub
ozil	OOV	aal
@lexzydoo_ab	NO	@lexzydoo_ab
opolo	OOV	apollo
eyes	OOV	aedes
u	IV	u
no	IV	no
fit	IV	fit
open	IV	open
eyes	OOV	aedes
u	IV	u
have	IV	have
a	IV	a
very	IV	very
sexy	IV	sexy
header	IV	header
@jaibrooks1	NO	@jaibrooks1
rawr	OOV	aer
i	IV	i
miss	IV	miss
u	IV	u
my	IV	my
bie	OOV	abbie
where	IV	where
u	IV	u
wanna	OOV	anna
out	IV	out
wif	OOV	gif
me	IV	me
have	IV	have
a	IV	a
wonderful	IV	wonderful
day	IV	day
like	IV	like
a	IV	a
swan	IV	swan
day	IV	day
haha	OOV	aha
cantik	OOV	cantic
rt	OOV	art
@historyinpics	NO	@historyinpics
julie	IV	julie
christie	IV	christie
,	OOV	choristic
1968	NO	1968
photograph	IV	photograph
by	IV	by
richard	IV	richard
avedon	OOV	aaron
http://t.co/gscav8o0ik	NO	http://t.co/gscav8o0ik
rt	OOV	art
@fvckxhemmings	NO	@fvckxhemmings
did	IV	did
calum	OOV	ahum
slip	IV	slip
omfg	OOV	comfy
@daviddarkshade	NO	@daviddarkshade
and	IV	and
you	IV	you
didnt	IV	didnt
make	IV	make
this	IV	this
brah	OOV	abram
my	IV	my
friend	IV	friend
jack	IV	jack
storm	IV	storm
did	IV	did
@xoxoxyareli	NO	@xoxoxyareli
@billmillerprobz	NO	@billmillerprobz
pshh	OOV	psha
i	IV	i
went	IV	went
and	IV	and
got	IV	got
mine	IV	mine
done	IV	done
regardless	IV	regardless
im	OOV	aim
sick	IV	sick
of	IV	of
not	IV	not
being	IV	being
able	IV	able
to	IV	to
be	IV	be
a	IV	a
girl	IV	girl
haha	OOV	aha
@tindency	NO	@tindency
syempre	OOV	abampere
in	IV	in
the	IV	the
right	IV	right
age	IV	age
hahaha	OOV	bahama
